21100000000000000000
00111111110000011110
00100000011111110010
00100000000000010010
01111111100000010010
01000000001111110010
01000000000000000010
01111111100000111010
00000000100000100010
00000000111111100010
00000000000000000010
11111111100000000010
00000000111111111110
00010000100000000000
00010000111111110000
00011111100000010010
00000000100000010010
00000000100000100010
00111111111111111110
00000000000000000013
